R 1000 1000
C 0,64,255
F 128,128,128
NO ./textno.xpm
WE ./textwe.xpm
SO ./textso.xpm
EA ./textea.xpm
S ./sprite.xpm

111111111
111111111111111111111111111
1000000000000000000000000001
1000222222222222222000000001
1000000000000000000000000001
1000222222222222222000000001
1000000000000000000101000001
1000222222222222N22010000001
1000222222222222222000000001
1000000000000000000000000001
1000222222222222222000000001
1000000000000000000000000001
1111111111111111111111111111
111
1
1
11111